1111111111111111111111111111
1C0000000000001010C001000001
1C00000000001000000100000001
1C00000000001000000100000001
1C00000000001000000100000001
1C00000000001000000100000001
1E11111111111101111111111111
1P000000000000000000000000C1
1111111111111111111111111111
