11111
10001
1C001
1E001
1P0P1
11111
