1111111111111111111111111111
1E1000100010001010000100C001
1000100010001010000100000101
1111111111111011111101111101
1P000000000000000000000001C1
1111111111111111111111111111