1111111111111111111111111111
1C00000000000010100001000001
1C00000000001000000100000001
1E11111111111101111111111111
1P00000000000000000000000001
1111111111111111111111111111
